味全优酪乳	酸牛奶
优酪乳	酸牛奶
李錦記	瓶装酱料
山楂枸杞	酸牛奶
风味酸牛奶	酸牛奶
新希望	瓶装酱料
蔓越莓蓝莓	酸牛奶
蒙牛大果粒	酸牛奶
大果粒	酸牛奶
蓝莓酸牛奶	酸牛奶
蔓越莓蓝莓酸牛奶	酸牛奶
酸牛奶	酸牛奶
鲜蚝油	瓶装酱料
味蚝鲜蚝油	瓶装酱料
鸿光浪花	瓶装酱料
超值鲜嫩火腿	火腿
中華豆腐	豆腐
西湖老酸奶	酸牛奶
现代牧场	牛奶
鲜牛奶	牛奶
卡夫蛋黄	瓶装酱料
优选芦荟	酸牛奶
温馨汤锅	瓶装酱料
天喜温馨汤锅	瓶装酱料
亨氏番茄沙司	瓶装酱料
番茄沙司	瓶装酱料
乌江	榨菜
蜜桃多	果汁
小龙女	果汁
四季鲜选	果汁
高钙奶	牛奶
畅优	酸牛奶
鲜爽菜丝	榨菜
果缤纷	果汁
纯牛奶	牛奶
美汁源	果汁
鲜香榨菜	榨菜
纯果乐	果汁
青岛啤酒	罐装啤酒
精炖番茄牛肉面	方便面
椰树	果汁
酷儿	碳酸饮料
脆口榨菜	榨菜
苹果醋	果汁
王老吉	凉茶
碧纯	酸牛奶
牛肉面	方便面
冰红茶	冰红茶
老坛酸菜牛肉面	方便面
雪碧	雪碧
统一老坛酸菜牛肉面	方便面
昆仑山	矿泉水
打卤面	方便面
鲜香菇打卤面	方便面
红烧牛肉面	方便面
怡宝	矿泉水
加多宝	凉茶
香飘飘	奶茶
精肉	肉制品
农夫山泉	矿泉水
辣味腐乳	罐头
正宗绍兴腐乳	罐头
老字号正宗辣味腐乳	罐头
厚德载物上善若水	凉茶
厚德载物	凉茶
上善若水	凉茶
沙司	瓶装酱料
爽歪歪	酸牛奶
龙井茶	茶叶
鸡肉火腿肠	火腿肠
桂酒	果酒
火腿肠	火腿肠
铁观音	茶叶
桂花酒	果酒
双汇泡面拍档	火腿肠
泡面拍档	火腿肠
汇源	果汁
榨菜	榨菜
红枣	牛奶
牛奶	牛奶
咸亨	瓶装酱料
红茶	冰红茶
腐乳	罐头
美年达	碳酸饮料
每日C	果汁
鸡蛋面	面制品
博大鸡蛋面	面制品
光明纯牛奶	牛奶
香榨菜	榨菜
小吃佬	零食
喜力	瓶装啤酒
统一阿萨姆	奶茶
阿萨姆	奶茶
水易方	矿泉水
恒大冰泉	矿泉水
西冷牛排	瓶装酱料
娃哈哈	矿泉水
黑椒味西冷牛排	瓶装酱料
亨氏番茄酱	番茄酱
午餐肉罐头	罐头
雪花	瓶装啤酒
芬达	芬达
老坛酸菜面	方便面
发酵乳	酸牛奶
雪花啤酒勇闯天涯	瓶装啤酒
雪花啤酒	瓶装啤酒
勇闯天涯	瓶装啤酒
胎菊	茶叶
拌饭酱	瓶装酱料
辣椒酱	瓶装酱料
哈尔滨啤酒	瓶装啤酒
古道菊品	茶叶
招牌拌饭酱	瓶装酱料
巨树牌	罐头
麻油白腐乳	罐头
雪碧释放夏日	雪碧
巨树牌白腐乳	罐头
零度可乐	碳酸饮料
优乐美	奶茶
百事可乐	碳酸饮料
可口可乐	碳酸饮料
冠益乳	酸牛奶
旺旺	牛奶
芦荟风味酸牛奶	酸牛奶
光明鲜牛奶	牛奶
旺仔牛奶	牛奶
高筋银丝挂面	面制品
晶玉榨菜	榨菜
风味挂面	面制品
老蒋榨菜	榨菜
优倍畅轻	酸牛奶
蒙牛畅轻	酸牛奶
千岛湖	瓶装啤酒
牧场鲜牛奶	牛奶
光明畅轻	酸牛奶
伊利纯牛奶	牛奶
陈克明荞麦风味挂面	面制品
荞麦风味挂面	面制品
水晶葡萄	果汁
伊利十运信赖见品质	牛奶
水溶C	果汁
去皮老蒋榨菜	榨菜
