味全优酪乳	酸牛奶
乳酪优全味	酸牛奶
优酪乳	酸牛奶
乳酪优	酸牛奶
李錦記	瓶装酱料
記錦李	瓶装酱料
山楂枸杞	酸牛奶
杞枸楂山	酸牛奶
风味酸牛奶	酸牛奶
奶牛酸味风	酸牛奶
新希望	瓶装酱料
望希新	瓶装酱料
蔓越莓蓝莓	酸牛奶
莓蓝莓越蔓	酸牛奶
蒙牛大果粒	酸牛奶
粒果大牛蒙	酸牛奶
大果粒	酸牛奶
粒果大	酸牛奶
蓝莓酸牛奶	酸牛奶
奶牛酸莓蓝	酸牛奶
蔓越莓蓝莓酸牛奶	酸牛奶
奶牛酸莓蓝莓越蔓	酸牛奶
酸牛奶	酸牛奶
奶牛酸	酸牛奶
鲜蚝油	瓶装酱料
油蚝鲜	瓶装酱料
味蚝鲜蚝油	瓶装酱料
油蚝鲜蚝味	瓶装酱料
鸿光浪花	瓶装酱料
花浪光鸿	瓶装酱料
超值鲜嫩火腿	火腿
腿火嫩鲜值超	火腿
中華豆腐	豆腐
腐豆華中	豆腐
西湖老酸奶	酸牛奶
奶酸老湖西	酸牛奶
现代牧场	牛奶
场牧代现	牛奶
鲜牛奶	牛奶
奶牛鲜	牛奶
卡夫蛋黄	瓶装酱料
黄蛋夫卡	瓶装酱料
优选芦荟	酸牛奶
荟芦选优	酸牛奶
温馨汤锅	瓶装酱料
锅汤馨温	瓶装酱料
天喜温馨汤锅	瓶装酱料
锅汤馨温喜天	瓶装酱料
亨氏番茄沙司	瓶装酱料
司沙茄番氏亨	瓶装酱料
番茄沙司	瓶装酱料
司沙茄番	瓶装酱料
乌江	榨菜
江乌	榨菜
蜜桃多	果汁
多桃蜜	果汁
小龙女	果汁
女龙小	果汁
四季鲜选	果汁
选鲜季四	果汁
高钙奶	牛奶
奶钙高	牛奶
畅优	酸牛奶
优畅	酸牛奶
鲜爽菜丝	榨菜
丝菜爽鲜	榨菜
果缤纷	果汁
纷缤果	果汁
纯牛奶	牛奶
奶牛纯	牛奶
美汁源	果汁
源汁美	果汁
鲜香榨菜	榨菜
菜榨香鲜	榨菜
纯果乐	果汁
乐果纯	果汁
青岛啤酒	罐装啤酒
酒啤岛青	罐装啤酒
精炖番茄牛肉面	方便面
面肉牛茄番炖精	方便面
椰树	果汁
树椰	果汁
酷儿	碳酸饮料
儿酷	碳酸饮料
脆口榨菜	榨菜
菜榨口脆	榨菜
苹果醋	果汁
醋果苹	果汁
王老吉	凉茶
吉老王	凉茶
碧纯	酸牛奶
纯碧	酸牛奶
牛肉面	方便面
面肉牛	方便面
冰红茶	冰红茶
茶红冰	冰红茶
老坛酸菜牛肉面	方便面
面肉牛菜酸坛老	方便面
雪碧	雪碧
碧雪	雪碧
统一老坛酸菜牛肉面	方便面
面肉牛菜酸坛老一统	方便面
昆仑山	矿泉水
山仑昆	矿泉水
打卤面	方便面
面卤打	方便面
鲜香菇打卤面	方便面
面卤打菇香鲜	方便面
红烧牛肉面	方便面
面肉牛烧红	方便面
怡宝	矿泉水
宝怡	矿泉水
加多宝	凉茶
宝多加	凉茶
香飘飘	奶茶
飘飘香	奶茶
精肉	肉制品
肉精	肉制品
农夫山泉	矿泉水
泉山夫农	矿泉水
辣味腐乳	罐头
乳腐味辣	罐头
正宗绍兴腐乳	罐头
乳腐兴绍宗正	罐头
老字号正宗辣味腐乳	罐头
乳腐味辣宗正号字老	罐头
厚德载物上善若水	凉茶
水若善上物载德厚	凉茶
厚德载物	凉茶
物载德厚	凉茶
上善若水	凉茶
水若善上	凉茶
沙司	瓶装酱料
司沙	瓶装酱料
爽歪歪	酸牛奶
歪歪爽	酸牛奶
龙井茶	茶叶
茶井龙	茶叶
鸡肉火腿肠	火腿肠
肠腿火肉鸡	火腿肠
桂酒	果酒
酒桂	果酒
火腿肠	火腿肠
肠腿火	火腿肠
铁观音	茶叶
音观铁	茶叶
桂花酒	果酒
酒花桂	果酒
双汇泡面拍档	火腿肠
档拍面泡汇双	火腿肠
泡面拍档	火腿肠
档拍面泡	火腿肠
汇源	果汁
源汇	果汁
榨菜	榨菜
菜榨	榨菜
红枣	牛奶
枣红	牛奶
牛奶	牛奶
奶牛	牛奶
咸亨	瓶装酱料
亨咸	瓶装酱料
红茶	冰红茶
茶红	冰红茶
腐乳	罐头
乳腐	罐头
美年达	碳酸饮料
达年美	碳酸饮料
每日C	果汁
C日每	果汁
鸡蛋面	面制品
面蛋鸡	面制品
博大鸡蛋面	面制品
面蛋鸡大博	面制品
光明纯牛奶	牛奶
奶牛纯明光	牛奶
香榨菜	榨菜
菜榨香	榨菜
小吃佬	零食
佬吃小	零食
喜力	瓶装啤酒
力喜	瓶装啤酒
统一阿萨姆	奶茶
姆萨阿一统	奶茶
阿萨姆	奶茶
姆萨阿	奶茶
水易方	矿泉水
方易水	矿泉水
恒大冰泉	矿泉水
泉冰大恒	矿泉水
西冷牛排	瓶装酱料
排牛冷西	瓶装酱料
娃哈哈	矿泉水
哈哈娃	矿泉水
黑椒味西冷牛排	瓶装酱料
排牛冷西味椒黑	瓶装酱料
亨氏番茄酱	番茄酱
酱茄番氏亨	番茄酱
午餐肉罐头	罐头
头罐肉餐午	罐头
雪花	瓶装啤酒
花雪	瓶装啤酒
芬达	芬达
达芬	芬达
老坛酸菜面	方便面
面菜酸坛老	方便面
发酵乳	酸牛奶
乳酵发	酸牛奶
雪花啤酒勇闯天涯	瓶装啤酒
涯天闯勇酒啤花雪	瓶装啤酒
雪花啤酒	瓶装啤酒
酒啤花雪	瓶装啤酒
勇闯天涯	瓶装啤酒
涯天闯勇	瓶装啤酒
胎菊	茶叶
菊胎	茶叶
拌饭酱	瓶装酱料
酱饭拌	瓶装酱料
辣椒酱	瓶装酱料
酱椒辣	瓶装酱料
哈尔滨啤酒	瓶装啤酒
酒啤滨尔哈	瓶装啤酒
古道菊品	茶叶
品菊道古	茶叶
招牌拌饭酱	瓶装酱料
酱饭拌牌招	瓶装酱料
巨树牌	罐头
牌树巨	罐头
麻油白腐乳	罐头
乳腐白油麻	罐头
雪碧释放夏日	雪碧
日夏放释碧雪	雪碧
巨树牌白腐乳	罐头
乳腐白牌树巨	罐头
零度可乐	碳酸饮料
乐可度零	碳酸饮料
优乐美	奶茶
美乐优	奶茶
百事可乐	碳酸饮料
乐可事百	碳酸饮料
可口可乐	碳酸饮料
乐可口可	碳酸饮料
冠益乳	酸牛奶
乳益冠	酸牛奶
旺旺	牛奶
旺旺	牛奶
芦荟风味酸牛奶	酸牛奶
奶牛酸味风荟芦	酸牛奶
光明鲜牛奶	牛奶
奶牛鲜明光	牛奶
旺仔牛奶	牛奶
奶牛仔旺	牛奶
高筋银丝挂面	面制品
面挂丝银筋高	面制品
晶玉榨菜	榨菜
菜榨玉晶	榨菜
风味挂面	面制品
面挂味风	面制品
老蒋榨菜	榨菜
菜榨蒋老	榨菜
优倍畅轻	酸牛奶
轻畅倍优	酸牛奶
蒙牛畅轻	酸牛奶
轻畅牛蒙	酸牛奶
千岛湖	瓶装啤酒
湖岛千	瓶装啤酒
牧场鲜牛奶	牛奶
奶牛鲜场牧	牛奶
光明畅轻	酸牛奶
轻畅明光	酸牛奶
伊利纯牛奶	牛奶
奶牛纯利伊	牛奶
陈克明荞麦风味挂面	面制品
面挂味风麦荞明克陈	面制品
荞麦风味挂面	面制品
面挂味风麦荞	面制品
水晶葡萄	果汁
萄葡晶水	果汁
伊利十运信赖见品质	牛奶
质品见赖信运十利伊	牛奶
水溶C	果汁
C溶水	果汁
去皮老蒋榨菜	榨菜
菜榨蒋老皮去	榨菜
